11111111111111111111111111111111111111
1P                1  1          1    1
1                 1  1          1    1
1111111111111111  1  111111111  1  111
1  1              1     1            1
1  1              1     1            1
1  1  1111111111  1  1  1  11111111  1
1  1  1     1  1     1     1         1
1  1  1     1  1     1     1         1
1        1     1     1     1         1
1        1     1111111  11111111111111
1111111111111  1                1    1
1  1     1     1                1    1
1  1           1  11111111111111111  1
1  1  1     1  1  1                  1
1  1  1111111  1  1                  1
1           1  1  1   1111111111111111
1           1  1  1   111111111111   1
1111111111  1  1                     1
1           1  1                     1
1           1  1  11111111111111111  1
1  1111111111  1                  1  1
1           1  1                  1  1
1           1  11111111111111111111  1
1111111111111  1            1     1  1
1  1     1     1            1     1  1
1  1     1     1  11111111  1  1  1111
1     1     1     1            1     1
1     1     1     1            1    E1
11111111111111111111111111111111111111
