11111111111111111
1               1
1111 111111111111
1111   1111111111
11111 11111111111
11111 11111111111
11111      111111
1111111111 111111
111111111   11111
111111111   11111
111111111P1111111
11111111111111111
