111111111111111
1P           P1
1             1
1             1
1             1
1P           P1
111111111111111
